11111111111111111111111111
10000000000000000000000001
10P000C0111000001111100001
1000001101100C010001100001
10000110011000000011000001
10001111111110000110000001
10000000011000011000000001
100000000110001111110E0001
10000000000000000000000001
11111111111111111111111111