1111111111111111111111111111111111
1000000000000000000000000000000001
100000000000000101000C000000000001
1000000000000011111000000000000001
1000000000000001110000000000000001
10P000000C00C0001000000000E00000C1
1000000000000000000000000000000001
1111111111111111111111111111111111