1111111111111111111111111111111111
1000000000000000000000000000000001
1E0000000000000101000C000000000001
1000000000000011111000000000000001
1000000000000001110000000000000001
1P0000000C00C0001000000000000000C1
1000000000000000000000000000000001
1111111111111111111111111111111111